[level]
tileset = grid.png
map = .....................................................................................................................
      ..###..#..###..###.#..#.###.#...#.###................................................................................
      ..#.#.#.#.#....#...####.#.#.##.##.#.#................................................................................
      ..###.#.#.#.##.#...#..#.###.#.#.#.###................................................................................
      ..#....#..###..###.#..#.#.#.#...#.#..................................................................................
      .....................................................................................................................
      .....................................................................................................................
      ..###..#..###..###.#..#.###.#...#.###................................................................................
      ..#.#.#.#.#....#...####.#.#.##.##.#.#................................................................................
      ..###.#.#.#.##.#...#..#.###.#.#.#.###................................................................................
      ..#....#..###..###.#..#.#.#.#...#.#..................................................................................
      .....................................................................................................................
      .....................................................................................................................
      ..###..#..###..###.#..#.###.#...#.###................................................................................
      ..#.#.#.#.#....#...####.#.#.##.##.#.#................................................................................
      ..###.#.#.#.##.#...#..#.###.#.#.#.###.......................#........................................................
      ..#....#..###..###.#..#.#.#.#...#.#..................................................................................
      .....................................................................................................................
      .....................................................................................................................
      ..###..#..###..###.#..#.###.#...#.###................................................................................
      ..#.#.#.#.#....#...####.#.#.##.##.#.#................................................................................
      ..###.#.#.#.##.#...#..#.###.#.#.#.###................................................................................
      ..#....#..###..###.#..#.#.#.#...#.#..................................................................................
      .....................................................................................................................
      .....................................................................................................................
      ..###..#..###..###.#..#.###.#...#.###................................................................................
      ..#.#.#.#.#....#...####.#.#.##.##.#.#................................................................................
      ..###.#.#.#.##.#...#..#.###.#.#.#.###................................................................................
      ..#....#..###..###.#..#.#.#.#...#.#..................................................................................
      .....................................................................................................................
      .....................................................................................................................
      ..###..#..###..###.#..#.###.#...#.###................................................................................
      ..#.#.#.#.#....#...####.#.#.##.##.#.#................................................................................
      ..###.#.#.#.##.#...#..#.###.#.#.#.###................................................................................
      ..#....#..###..###.#..#.#.#.#...#.#..................................................................................
      .....................................................................................................................


[.]
tile = 0, 1
wall = false
block = false

[#]
tile = 0, 0
wall = true
block = true